111111111111111
1P1000000000001
1C0100010011001
100CCC0000C00E1
111111111111111
